10 10 10 10 10 10 10 10 10 10 10 10 10 10 10 10 10 10 10 10 10 10 10 10 10 10 10 10 10 10 10 10 10 10 10 10 10 10 10 10 10 10 10 10 10 10 10 10 10 10 10 10 10 10 10 10 10 10 10 10 10 10 10 10 10 10 10 10 10 10 10 10 10 10 10 10 10 10 10 10 10 10 10 10 10 10 10 10 10 10 10 10 10 10 10 10 10 10 10 10 
10 10 10 10 10 10 10 10 10 10 10 10 10 10 10 10 10 10 10 10 10 10 10 10 10 10 10 10 10 10 10 10 10 10 10 10 10 10 10 10 10 10 10 10 10 10 10 10 10 10 10 10 10 10 10 10 10 10 10 10 10 10 10 10 10 10 10 10 10 10 10 10 10 10 10 10 10 10 10 10 10 10 10 10 10 10 10 10 10 10 10 10 10 10 10 10 10 10 10 10 
10 10 10 10 10 10 10 10 10 10 10 10 10 10 10 10 10 10 10 10 10 10 10 10 10 10 10 10 10 10 10 10 10 10 10 10 10 10 10 10 10 10 10 10 10 10 10 10 10 10 10 10 10 10 10 10 10 10 10 10 10 10 10 10 10 10 10 10 10 10 10 10 10 10 10 10 10 10 10 10 10 10 10 10 10 10 10 10 10 10 10 10 10 10 10 10 10 10 10 10 
10 10 10 10 10 10 10 10 10 10 10 10 10 10 10 10 10 10 10 10 10 10 10 10 10 10 10 10 10 10 10 10 10 10 10 10 10 10 10 10 10 10 10 10 10 10 10 10 10 10 10 10 10 10 10 10 10 10 10 10 10 10 10 10 10 10 10 10 10 10 10 10 10 10 10 10 10 10 10 10 10 10 10 10 10 10 10 10 10 10 10 10 10 10 10 10 10 10 10 10 
10 10 10 10 10 10 10 10 10 10 10 10 10 10 10 10 10 10 10 10 10 10 10 10 10 10 10 10 10 10 10 10 10 10 10 10 10 10 10 10 10 10 10 10 10 10 10 10 10 10 10 10 10 10 10 10 10 10 10 10 10 10 10 10 10 10 10 10 10 10 10 10 10 10 10 10 10 10 10 10 10 10 10 10 10 10 10 10 10 10 10 10 10 10 10 10 10 10 10 10 
10 10 10 10 10 10 10 10 10 10 10 10 10 10 10 10 10 10 10 10 10 10 10 10 10 10 10 10 10 10 10 10 10 10 10 10 10 10 10 10 10 10 10 10 10 10 10 10 10 10 10 10 10 10 10 10 10 10 10 10 10 10 10 10 10 10 10 10 10 10 10 10 10 10 10 10 10 10 10 10 10 10 10 10 10 10 10 10 10 10 10 10 10 10 10 10 10 10 10 10 
10 10 10 10 10 10 10 10 10 10 10 10 10 10 10 10 10 10 10 10 10 10 10 10 10 10 10 10 10 10 10 10 10 10 10 10 10 10 10 10 10 10 10 10 10 10 10 10 10 10 10 10 10 10 10 10 10 10 10 10 10 10 10 10 10 10 10 10 10 10 10 10 10 10 10 10 10 10 10 10 10 10 10 10 10 10 10 10 10 10 10 10 10 10 10 10 10 10 10 10 
10 10 10 10 10 10 10 10 10 10 10 10 10 10 10 10 10 10 10 10 10 10 10 10 10 10 10 10 10 10 10 10 10 10 10 10 10 10 10 10 10 10 10 10 10 10 10 10 10 10 10 10 10 10 10 10 10 10 10 10 10 10 10 10 10 10 10 10 10 10 10 10 10 10 10 10 10 10 10 10 10 10 10 10 10 10 10 10 10 10 10 10 10 10 10 10 10 10 10 10 
10 10 10 10 10 10 10 10 10 10 10 10 10 10 10 10 10 10 10 10 10 10 10 10 10 10 10 10 10 10 10 10 10 10 10 10 10 10 10 10 10 10 10 10 10 10 10 10 10 10 10 10 10 10 10 10 10 10 10 10 10 10 10 10 10 10 10 10 10 10 10 10 10 10 10 10 10 10 10 10 10 10 10 10 10 10 10 10 10 10 10 10 10 10 10 10 10 10 10 10 
10 10 10 10 10 10 10 10 10 10 10 10 10 10 10 10 10 10 10 10 10 10 10 10 10 10 10 10 10 10 10 10 10 10 10 10 10 10 10 10 10 10 10 10 10 10 10 10 10 10 10 10 10 10 10 10 10 10 10 10 10 10 10 10 10 10 10 10 10 10 10 10 10 10 10 10 10 10 10 10 10 10 10 10 10 10 10 10 10 10 10 10 10 10 10 10 10 10 10 10 
10 10 10 10 10 10 10 10 10 10 10 10 10 10 10 10 10 10 10 10 10 10 10 10 10 10 10 10 10 10 10 10 10 10 10 10 10 10 10 10 10 10 10 10 10 10 10 10 10 10 10 10 10 10 10 10 10 10 10 10 10 10 10 10 10 10 10 10 10 10 10 10 10 10 10 10 10 10 10 10 10 10 10 10 10 10 10 10 10 10 10 10 10 10 10 10 10 10 10 10 
10 10 10 10 10 10 10 10 10 10 10 10 10 10 10 10 10 10 10 10 10 10 10 10 10 10 10 10 10 10 10 10 10 10 10 10 10 10 10 10 10 10 10 10 10 10 10 10 10 10 10 10 10 10 10 10 10 10 10 10 10 10 10 10 10 10 10 10 10 10 10 10 10 10 10 10 10 10 10 10 10 10 10 10 10 10 10 10 10 10 10 10 10 10 10 10 10 10 10 10 
10 10 10 10 10 10 10 10 10 10 10 10 10 10 10 10 10 10 10 10 10 10 10 10 10 10 10 10 10 10 10 10 10 10 10 10 10 10 10 10 10 10 10 10 10 10 10 10 10 10 10 10 10 10 10 10 10 10 10 10 10 10 10 10 10 10 10 10 10 10 10 10 10 10 10 10 10 10 10 10 10 10 10 10 10 10 10 10 10 10 10 10 10 10 10 10 10 10 10 10 
10 10 10 10 10 10 10 10 10 10 10 10 10 10 10 10 10 10 10 10 10 10 10 10 10 10 10 10 10 10 10 10 10 10 10 10 10 10 10 10 10 10 10 10 10 10 10 10 10 10 10 10 10 10 10 10 10 10 10 10 10 10 10 10 10 10 10 10 10 10 10 10 10 10 10 10 10 10 10 10 10 10 10 10 10 10 10 10 10 10 10 10 10 10 10 10 10 10 10 10 
10 10 10 10 10 10 10 10 10 10 10 10 10 10 10 10 10 10 10 10 10 10 10 10 10 10 10 10 10 10 10 10 10 10 10 10 10 10 10 10 10 10 10 10 10 10 10 10 10 10 10 10 10 10 10 10 10 10 10 10 10 10 10 10 10 10 10 10 10 10 10 10 10 10 10 10 10 10 10 10 10 10 10 10 10 10 10 10 10 10 10 10 10 10 10 10 10 10 10 10 
10 10 10 10 10 10 10 10 10 10 10 10 10 10 10 10 10 10 10 10 10 10 10 10 10 10 10 10 10 10 10 10 10 10 10 10 10 10 10 10 10 10 10 10 10 10 10 10 10 10 10 10 10 10 10 10 10 10 10 10 10 10 10 10 10 10 10 10 10 10 10 10 10 10 10 10 10 10 10 10 10 10 10 10 10 10 10 10 10 10 10 10 10 10 10 10 10 10 10 10 
10 10 10 10 10 10 10 10 10 10 10 10 10 10 10 10 10 10 10 10 10 10 10 10 10 10 10 10 10 10 10 10 10 10 10 10 10 10 10 10 10 10 10 10 10 10 10 10 10 10 10 10 10 10 10 10 10 10 10 10 10 10 10 10 10 10 10 10 10 10 10 10 10 10 10 10 10 10 10 10 10 10 10 10 10 10 10 10 10 10 10 10 10 10 10 10 10 10 10 10 
10 10 10 10 10 10 10 10 10 10 10 10 10 10 10 10 10 10 10 10 10 10 10 10 10 10 10 10 10 10 10 10 10 10 10 10 10 10 10 10 10 10 10 10 10 10 10 10 10 10 10 10 10 10 10 10 10 10 10 10 10 10 10 10 10 10 10 10 10 10 10 10 10 10 10 10 10 10 10 10 10 10 10 10 10 10 10 10 10 10 10 10 10 10 10 10 10 10 10 10 
10 10 10 10 10 10 10 10 10 10 10 10 10 10 10 10 10 10 10 10 10 10 10 10 10 10 10 10 10 10 10 10 10 10 10 10 10 10 10 10 10 10 10 10 10 10 10 10 10 10 10 10 10 10 10 10 10 10 10 10 10 10 10 10 10 10 10 10 10 10 10 10 10 10 10 10 10 10 10 10 10 10 10 10 10 10 10 10 10 10 10 10 10 10 10 10 10 10 10 10 
10 10 10 10 10 10 10 10 10 10 10 10 10 10 10 10 10 10 10 10 10 10 10 10 10 10 10 10 10 10 10 10 10 10 10 10 10 10 10 10 10 10 10 10 10 10 10 10 10 10 10 10 10 10 10 10 10 10 10 10 10 10 10 10 10 10 10 10 10 10 10 10 10 10 10 10 10 10 10 10 10 10 10 10 10 10 10 10 10 10 10 10 10 10 10 10 10 10 10 10 
10 10 10 10 10 10 10 10 10 10 10 10 10 10 10 10 10 10 10 10 19 32 32 32 32 32 32 32 32 32 32 32 32 32 32 32 32 32 32 32 32 32 32 32 32 32 32 32 26 10 10 10 19 32 32 32 32 32 32 32 32 32 32 32 32 32 26 10 10 10 10 19 32 32 32 32 32 32 26 10 10 10 10 10 10 10 10 10 10 10 10 10 10 10 10 10 10 10 10 10 
10 10 10 10 10 10 10 10 10 10 10 10 10 10 10 10 10 10 10 10 16 12 12 12 12 12 12 12 12 12 12 12 12 12 12 12 12 12 12 12 29 12 14 12 12 12 12 12 23 10 10 10 16 12 12 12 12 31 12 12 12 12 12 12 12 12 17 32 32 32 32 25 12 12 12 12 12 12 23 10 10 10 10 10 10 10 10 10 10 10 10 10 10 10 10 10 10 10 10 10 
10 10 10 10 10 10 10 10 10 10 10 10 10 10 10 10 10 10 10 10 16 12 12 29 13 13 12 12 31 31 31 12 29 12 12 12 12 12 12 12 12 12 12 13 12 12 12 12 23 10 10 10 16 12 12 12 12 31 31 12 12 12 12 12 14 12 12 12 12 12 12 12 12 12 13 12 12 12 23 10 10 10 10 10 10 10 10 10 10 10 10 10 10 10 10 10 10 10 10 10 
10 10 10 10 10 10 10 10 10 10 10 10 10 10 10 10 10 10 10 10 16 12 12 13 13 12 31 31 12 12 12 12 12 12 12 12 12 12 20 9 9 27 12 13 12 31 12 12 17 32 32 32 25 12 12 14 12 12 12 31 31 12 12 12 14 12 12 12 12 12 12 12 12 12 13 13 31 12 23 10 10 10 10 10 10 10 10 10 10 10 10 10 10 10 10 10 10 10 10 10 
10 10 10 10 10 10 10 10 10 10 10 10 10 10 10 10 10 10 10 10 16 12 12 13 12 31 31 12 13 12 12 12 20 9 9 9 9 9 24 10 10 16 13 13 12 31 31 12 12 12 12 12 12 12 12 14 14 12 28 12 31 31 12 12 14 12 12 12 20 9 9 9 27 12 12 13 12 12 23 10 10 10 10 10 10 10 10 10 10 10 10 10 10 10 10 10 10 10 10 10 
10 10 10 10 10 10 10 10 10 10 10 10 10 10 10 10 10 10 10 10 16 12 12 13 12 31 12 13 13 20 9 9 24 10 10 10 10 10 10 10 19 25 13 12 12 29 31 12 12 12 12 12 12 12 12 12 14 14 12 12 12 31 31 12 14 12 12 12 23 10 10 10 16 12 31 13 28 12 23 10 10 10 10 10 10 10 10 10 10 10 10 10 10 10 10 10 10 10 10 10 
10 10 10 10 10 10 10 10 10 10 10 10 10 10 10 10 10 10 10 10 16 12 12 12 12 12 13 13 20 24 10 10 10 10 10 10 10 19 32 32 25 13 13 12 12 31 31 12 12 12 12 12 12 12 12 12 12 14 14 14 12 12 12 12 14 12 12 28 23 10 10 10 16 12 12 13 12 12 23 10 10 10 10 10 10 10 10 10 10 10 10 10 10 10 10 10 10 10 10 10 
10 10 10 10 10 10 10 10 10 10 10 10 10 10 10 10 10 10 10 10 16 12 12 29 12 13 13 12 23 10 10 10 10 10 10 19 32 25 12 12 12 13 12 31 31 31 12 12 20 9 9 9 27 12 12 12 12 12 29 12 14 14 14 12 12 14 12 12 23 10 10 10 16 12 12 13 12 12 23 10 10 10 10 10 10 10 10 10 10 10 10 10 10 10 10 10 10 10 10 10 
10 10 10 10 10 10 10 10 10 10 10 10 10 10 10 10 10 10 10 10 16 12 12 12 12 13 12 20 24 10 10 10 10 19 32 25 12 12 13 13 13 13 12 12 12 12 12 20 24 10 10 19 25 12 12 12 12 12 12 12 12 12 14 14 12 14 12 20 24 10 10 10 16 12 13 13 31 12 23 10 10 10 10 10 10 10 10 10 10 10 10 10 10 10 10 10 10 10 10 10 
10 10 10 10 10 10 10 10 10 10 10 10 10 10 10 10 10 10 10 10 16 12 12 12 12 12 12 23 10 10 10 19 32 25 12 12 12 12 12 12 12 12 12 12 12 20 9 24 10 10 19 25 12 12 12 12 31 31 31 12 12 12 12 12 12 14 12 23 10 10 10 10 16 12 12 12 12 12 23 10 10 10 10 10 10 10 10 10 10 10 10 10 10 10 10 10 10 10 10 10 
10 10 10 10 10 10 10 10 10 10 10 10 10 10 10 10 10 10 10 10 16 12 12 12 12 12 12 23 10 10 10 15 27 29 12 20 9 9 9 9 9 9 9 9 9 24 10 10 10 10 16 12 12 12 12 12 31 31 12 31 31 31 31 12 12 14 12 23 10 10 10 10 15 27 12 28 13 12 23 10 10 10 10 10 10 10 10 10 10 10 10 10 10 10 10 10 10 10 10 10 
10 10 10 10 10 10 10 10 10 10 10 10 10 10 10 10 10 10 10 10 15 9 9 9 27 12 12 17 26 10 10 10 15 9 9 24 10 10 10 10 10 10 10 10 10 10 10 10 10 19 25 12 12 12 12 12 12 31 12 12 12 12 12 12 12 14 12 23 10 10 10 10 10 16 12 12 31 12 23 10 10 10 10 10 10 10 10 10 10 10 10 10 10 10 10 10 10 10 10 10 
10 10 10 10 10 10 10 10 10 10 10 10 10 10 10 10 10 10 10 10 10 10 10 10 16 12 12 12 23 10 10 10 10 10 10 10 10 10 10 10 10 10 10 10 10 10 10 10 19 25 12 12 12 12 12 12 28 31 12 12 12 12 12 12 12 14 12 23 10 10 10 10 10 15 9 27 12 12 23 10 10 10 10 10 10 10 10 10 10 10 10 10 10 10 10 10 10 10 10 10 
10 10 10 10 10 10 10 10 10 10 10 10 10 10 10 10 10 10 10 10 10 10 10 10 16 12 12 12 23 10 10 10 10 10 10 10 10 10 10 10 10 10 10 10 10 10 10 10 16 12 12 12 12 12 12 12 12 31 12 12 12 12 12 12 12 12 20 24 10 10 10 10 10 10 10 16 12 12 23 10 10 10 10 10 10 10 10 10 10 10 10 10 10 10 10 10 10 10 10 10 
10 10 10 10 10 10 10 10 10 10 10 10 10 10 10 10 10 10 10 10 10 10 10 10 16 12 12 12 17 32 32 26 10 10 10 10 10 10 10 10 10 19 32 32 32 26 10 10 16 12 12 12 12 29 12 12 12 31 12 12 12 12 12 12 12 20 24 10 10 10 10 10 10 10 10 16 12 12 23 10 10 10 10 10 10 10 10 10 10 10 10 10 10 10 10 10 10 10 10 10 
10 10 10 10 10 10 10 10 10 10 10 10 10 10 10 10 10 10 10 10 10 10 10 10 16 12 12 12 12 12 31 17 32 32 32 32 32 32 32 32 32 25 31 12 12 17 32 32 25 12 14 14 12 12 12 12 12 12 12 12 12 12 12 12 12 23 10 10 10 10 10 10 10 10 10 16 12 12 23 10 10 10 10 10 10 10 10 10 10 10 10 10 10 10 10 10 10 10 10 10 
10 10 10 10 10 10 10 10 10 10 10 10 10 10 10 10 10 10 10 10 19 32 32 32 25 12 12 12 12 12 31 12 12 12 12 12 12 12 29 31 31 31 31 12 12 12 12 12 12 12 12 14 14 14 14 14 14 14 12 12 12 12 12 14 12 17 32 26 10 10 10 10 10 10 10 16 12 12 23 10 10 10 10 10 10 10 10 10 10 10 10 10 10 10 10 10 10 10 10 10 
10 10 10 10 10 10 10 10 10 10 10 10 10 10 10 10 10 10 10 10 16 12 12 12 12 12 12 12 12 12 31 31 12 12 14 14 12 31 31 12 12 12 12 12 12 12 12 28 12 12 12 12 12 12 12 12 12 14 12 12 28 29 28 14 14 12 12 17 32 32 32 32 32 32 32 25 12 12 23 10 10 10 10 10 10 10 10 10 10 10 10 10 10 10 10 10 10 10 10 10 
10 10 10 10 10 10 10 10 10 10 10 10 10 10 10 10 10 10 10 10 16 12 12 12 12 12 12 12 12 12 31 31 31 31 12 14 14 12 31 31 31 31 12 31 31 12 12 12 12 12 12 12 12 12 12 12 12 14 12 12 12 12 12 12 14 14 12 12 12 12 12 12 12 12 12 12 12 12 23 10 10 10 10 10 10 10 10 10 10 10 10 10 10 10 10 10 10 10 10 10 
10 10 10 10 10 10 10 10 10 10 10 10 10 10 10 10 10 10 10 10 16 12 12 31 12 12 12 12 12 12 31 12 12 12 12 12 14 14 14 12 12 12 12 31 12 12 14 14 12 12 12 31 31 31 12 12 14 12 12 12 12 12 12 12 12 14 14 14 14 14 12 12 12 12 12 12 12 12 23 10 10 10 10 10 10 10 10 10 10 10 10 10 10 10 10 10 10 10 10 10 
10 10 10 10 10 10 10 10 10 10 10 10 10 10 10 10 10 10 10 10 16 12 12 29 31 12 12 28 31 31 31 31 31 31 29 12 12 12 14 14 14 12 12 31 12 12 14 12 29 31 31 12 12 12 12 14 14 12 12 12 12 12 12 12 12 31 31 31 12 12 12 12 29 31 12 12 12 12 23 10 10 10 10 10 10 10 10 10 10 10 10 10 10 10 10 10 10 10 10 10 
10 10 10 10 10 10 10 10 10 10 10 10 10 10 10 10 10 10 10 10 16 12 12 12 31 31 31 31 31 12 12 12 12 12 31 31 12 12 12 12 12 12 12 31 12 14 12 12 31 31 12 12 12 12 14 14 12 12 12 12 12 12 12 12 12 14 12 12 31 31 31 31 31 31 12 12 12 20 24 10 10 10 10 10 10 10 10 10 10 10 10 10 10 10 10 10 10 10 10 10 
10 10 10 10 10 10 10 10 10 10 10 10 10 10 10 10 10 10 10 10 16 12 12 12 12 12 31 31 31 12 12 14 14 14 14 14 12 12 12 31 31 12 31 31 12 12 12 12 12 12 12 12 14 14 12 12 12 12 12 12 12 12 12 12 12 14 14 12 12 12 12 12 12 12 12 12 20 24 10 10 10 10 10 10 10 10 10 10 10 10 10 10 10 10 10 10 10 10 10 10 
10 10 10 10 10 10 10 10 10 10 10 10 10 10 10 10 10 10 10 10 16 12 12 12 12 12 12 12 13 12 12 12 12 12 12 12 12 12 12 31 29 12 31 12 12 12 12 12 12 12 12 14 14 12 12 12 12 20 9 9 9 9 9 9 27 12 14 14 12 12 12 12 12 12 20 9 24 10 10 10 10 10 10 10 10 10 10 10 10 10 10 10 10 10 10 10 10 10 10 10 
10 10 10 10 10 10 10 10 10 10 10 10 10 10 10 10 10 10 10 10 16 12 12 12 12 12 12 12 31 12 12 12 12 12 12 31 31 12 12 31 31 31 31 12 14 14 12 12 12 12 12 12 12 12 12 20 9 24 10 10 10 10 10 10 16 12 12 14 14 12 12 12 12 20 24 10 10 10 10 10 10 10 10 10 10 10 10 10 10 10 10 10 10 10 10 10 10 10 10 10 
10 10 10 10 10 10 10 10 10 10 10 10 10 10 10 10 10 10 10 10 16 12 29 12 12 14 12 12 12 31 12 12 31 31 31 31 31 12 12 12 12 31 31 12 14 12 12 12 12 12 12 12 12 12 12 23 10 10 10 10 10 10 10 10 15 27 12 12 14 14 12 12 20 24 10 10 10 10 10 10 10 10 10 10 10 10 10 10 10 10 10 10 10 10 10 10 10 10 10 10 
10 10 10 10 10 10 10 10 10 10 10 10 10 10 10 10 10 10 10 10 16 12 12 12 12 14 12 12 12 31 29 31 12 12 12 12 12 12 12 12 12 12 12 14 12 12 28 12 12 12 12 12 12 12 12 17 26 10 10 10 10 10 10 10 10 16 29 12 12 14 20 9 24 10 10 10 19 32 26 10 10 10 10 10 10 10 10 10 10 10 10 10 10 10 10 10 10 10 10 10 
10 10 10 10 10 10 10 10 10 10 10 10 10 10 10 10 10 10 10 10 16 12 12 12 12 14 12 12 12 12 31 12 12 12 12 12 12 12 12 12 12 12 14 14 12 12 12 12 12 12 12 12 12 12 29 20 24 10 10 10 10 10 10 10 10 16 28 12 12 20 24 10 10 10 10 19 25 12 23 10 10 10 10 10 10 10 10 10 10 10 10 10 10 10 10 10 10 10 10 10 
10 10 10 10 10 10 10 10 10 10 10 10 10 10 10 10 10 10 10 10 16 12 12 12 12 14 12 12 12 12 12 12 12 12 12 12 14 14 14 14 14 14 14 12 12 12 12 12 12 12 12 12 12 20 9 24 10 10 10 10 10 10 10 10 10 15 9 27 20 24 10 10 10 19 32 25 12 12 23 10 10 10 10 10 10 10 10 10 10 10 10 10 10 10 10 10 10 10 10 10 
10 10 10 10 10 10 10 10 10 10 10 10 10 10 10 10 10 10 10 10 16 12 12 12 12 14 12 12 12 28 12 12 12 12 12 12 12 12 12 12 12 12 12 12 12 12 12 12 12 12 12 12 20 24 10 10 10 10 10 10 10 10 10 10 10 10 10 15 24 10 10 19 32 25 12 12 12 12 23 10 10 10 10 10 10 10 10 10 10 10 10 10 10 10 10 10 10 10 10 10 
10 10 10 10 10 10 10 10 10 10 10 10 10 10 10 10 10 10 10 10 16 12 12 12 12 14 14 12 12 12 12 12 12 12 12 12 12 12 12 20 9 9 9 9 9 9 9 27 12 12 12 12 23 10 10 10 10 10 10 10 10 10 10 10 10 10 10 10 10 10 10 16 12 12 12 12 28 12 23 10 10 10 10 10 10 10 10 10 10 10 10 10 10 10 10 10 10 10 10 10 
10 10 10 10 10 10 10 10 10 10 10 10 10 10 10 10 10 10 10 10 16 12 12 12 12 12 14 12 12 12 12 12 12 31 31 12 12 12 12 23 10 10 10 10 10 10 10 16 12 12 12 12 23 10 10 10 10 10 10 10 10 10 10 10 10 10 10 10 10 19 32 25 12 12 12 12 12 12 23 10 10 10 10 10 10 10 10 10 10 10 10 10 10 10 10 10 10 10 10 10 
10 10 10 10 10 10 10 10 10 10 10 10 10 10 10 10 10 10 10 10 16 12 12 12 12 29 12 12 12 12 12 12 12 12 31 29 12 12 12 23 10 10 10 10 10 10 10 16 12 12 12 12 17 32 32 32 32 26 10 10 10 10 10 10 19 32 32 32 32 25 12 12 12 12 12 12 12 12 23 10 10 10 10 10 10 10 10 10 10 10 10 10 10 10 10 10 10 10 10 10 
10 10 10 10 10 10 10 10 10 10 10 10 10 10 10 10 10 10 10 10 16 12 12 12 12 12 12 12 12 12 12 14 12 12 12 31 12 12 12 23 10 10 10 10 10 10 10 16 12 12 12 12 12 12 12 12 12 17 26 10 10 10 10 19 25 28 12 12 12 12 12 12 12 12 12 29 12 12 23 10 10 10 10 10 10 10 10 10 10 10 10 10 10 10 10 10 10 10 10 10 
10 10 10 10 10 10 10 10 10 10 10 10 10 10 10 10 10 10 10 10 16 12 12 28 12 12 12 12 12 12 12 14 12 12 12 31 31 12 12 23 10 10 10 19 26 10 19 25 12 12 12 12 12 28 12 12 12 12 17 32 32 32 32 25 12 12 12 12 12 12 12 12 12 12 12 12 12 12 23 10 10 10 10 10 10 10 10 10 10 10 10 10 10 10 10 10 10 10 10 10 
10 10 10 10 10 10 10 10 10 10 10 10 10 10 10 10 10 10 10 10 16 12 12 12 12 20 9 9 9 9 27 14 12 12 12 12 31 12 12 23 10 10 19 25 17 32 25 12 12 12 12 12 12 12 12 12 12 12 12 12 12 12 29 12 12 12 12 12 12 12 12 31 31 12 12 12 12 12 23 10 10 10 10 10 10 10 10 10 10 10 10 10 10 10 10 10 10 10 10 10 
10 10 10 10 10 10 10 10 10 10 10 10 10 10 10 10 10 10 10 10 16 12 12 12 12 23 10 10 10 10 16 12 14 12 12 12 12 12 20 24 10 10 16 12 12 12 12 12 12 12 14 12 12 12 29 12 12 12 12 12 12 31 31 31 31 31 31 31 31 31 31 12 12 12 12 12 12 12 23 10 10 10 10 10 10 10 10 10 10 10 10 10 10 10 10 10 10 10 10 10 
10 10 10 10 10 10 10 10 10 10 10 10 10 10 10 10 10 10 10 10 16 12 12 12 12 23 10 10 10 10 16 12 14 12 31 12 12 12 23 10 10 10 16 12 12 12 12 14 14 12 14 12 12 12 31 31 31 31 12 13 12 31 12 12 12 12 12 12 12 12 12 12 12 12 12 12 12 12 23 10 10 10 10 10 10 10 10 10 10 10 10 10 10 10 10 10 10 10 10 10 
10 10 10 10 10 10 10 10 10 10 10 10 10 10 10 10 10 10 10 10 16 12 12 29 20 24 10 10 19 32 25 12 14 14 12 12 12 12 23 10 10 10 16 12 12 29 12 14 14 14 14 12 13 12 31 12 12 31 12 13 12 31 12 12 12 12 12 12 12 13 12 12 12 12 12 13 12 12 23 10 10 10 10 10 10 10 10 10 10 10 10 10 10 10 10 10 10 10 10 10 
10 10 10 10 10 10 10 10 10 10 10 10 10 10 10 10 10 10 10 10 16 12 20 9 24 10 10 10 16 12 12 12 12 14 12 12 12 12 23 10 10 10 15 27 12 28 12 12 14 12 14 14 13 13 12 12 29 31 13 13 12 31 31 12 12 12 12 12 13 12 12 12 12 12 13 12 12 12 23 10 10 10 10 10 10 10 10 10 10 10 10 10 10 10 10 10 10 10 10 10 
10 10 10 10 10 10 10 10 10 10 10 10 10 10 10 10 10 10 10 10 16 12 23 10 10 10 19 32 25 12 12 31 12 14 14 12 31 12 17 26 10 10 10 16 12 12 12 12 14 14 12 14 12 13 12 12 31 31 13 13 12 12 31 12 12 12 12 13 13 12 29 28 12 12 13 12 12 12 23 10 10 10 10 10 10 10 10 10 10 10 10 10 10 10 10 10 10 10 10 10 
10 10 10 10 10 10 10 10 10 10 10 10 10 10 10 10 10 10 10 10 15 9 24 10 10 10 15 27 31 12 12 12 12 12 14 12 12 12 12 23 10 10 10 15 9 9 27 12 12 14 14 14 12 13 13 12 12 12 12 13 12 12 31 31 31 31 12 13 12 12 12 12 12 12 13 12 12 12 23 10 10 10 10 10 10 10 10 10 10 10 10 10 10 10 10 10 10 10 10 10 
10 10 10 10 10 10 10 10 10 10 10 10 10 10 10 10 10 10 10 10 10 10 10 10 10 10 10 16 12 12 12 12 12 12 14 14 12 12 29 23 10 10 10 10 10 10 15 27 12 12 14 14 28 12 13 13 12 12 12 13 13 12 12 31 29 12 13 13 12 12 12 12 12 12 13 12 12 12 23 10 10 10 10 10 10 10 10 10 10 10 10 10 10 10 10 10 10 10 10 10 
10 10 10 10 10 10 10 10 10 10 10 10 10 10 10 10 10 10 10 10 10 10 10 10 10 10 10 16 12 12 29 12 12 31 12 14 12 12 12 23 10 10 10 10 10 10 10 15 9 27 12 12 12 29 12 12 13 13 12 12 13 12 12 12 12 13 13 12 12 31 31 31 12 12 13 12 12 12 23 10 10 10 10 10 10 10 10 10 10 10 10 10 10 10 10 10 10 10 10 10 
10 10 10 10 10 10 10 10 10 10 10 10 10 10 10 10 10 10 10 10 10 10 10 10 10 10 10 16 12 12 12 12 12 12 12 14 14 12 31 17 32 32 26 10 10 10 10 10 10 15 27 12 12 12 12 12 12 12 12 12 13 13 13 13 13 13 12 12 31 31 12 12 12 12 13 12 12 12 23 10 10 10 10 10 10 10 10 10 10 10 10 10 10 10 10 10 10 10 10 10 
10 10 10 10 10 10 10 10 10 10 10 10 10 10 10 10 10 10 10 10 10 10 10 10 10 10 10 15 9 27 12 12 12 12 12 12 14 14 12 12 12 12 17 26 19 32 32 32 32 32 25 12 12 12 12 12 12 12 12 12 12 12 12 12 12 12 31 31 31 12 12 12 12 13 12 12 12 12 23 10 10 10 10 10 10 10 10 10 10 10 10 10 10 10 10 10 10 10 10 10 
10 10 10 10 10 10 10 10 10 10 10 10 10 10 10 10 10 10 10 10 10 10 10 10 10 10 10 10 10 16 12 12 12 12 31 12 12 14 12 12 12 12 12 17 25 12 12 12 12 12 12 12 12 12 12 12 12 12 12 31 31 31 12 12 12 12 12 12 12 12 12 12 12 13 12 12 12 12 23 10 10 10 10 10 10 10 10 10 10 10 10 10 10 10 10 10 10 10 10 10 
10 10 10 10 10 10 10 10 10 10 10 10 10 10 10 10 10 10 10 10 10 10 10 10 10 10 10 10 10 16 12 12 12 12 12 12 12 12 12 12 12 12 12 12 12 12 12 12 12 12 12 12 20 9 27 12 12 12 12 12 12 31 31 29 12 12 12 12 31 31 12 12 12 13 12 12 29 12 23 10 10 10 10 10 10 10 10 10 10 10 10 10 10 10 10 10 10 10 10 10 
10 10 10 10 10 10 10 10 10 10 10 10 10 10 10 10 10 10 10 10 19 32 32 32 26 10 10 10 10 16 12 12 12 12 12 12 12 12 12 12 12 12 29 12 12 12 12 12 12 20 9 9 24 10 16 12 12 12 12 12 12 12 12 31 12 12 12 31 12 12 12 12 12 13 12 12 28 12 23 10 10 10 10 10 10 10 10 10 10 10 10 10 10 10 10 10 10 10 10 10 
10 10 10 10 10 10 10 10 10 10 10 10 10 10 10 10 10 10 10 10 16 12 12 12 17 26 10 10 10 16 12 12 29 12 12 12 12 12 31 31 31 31 31 12 12 12 12 12 28 23 10 10 10 10 16 12 12 13 13 13 13 12 12 12 31 31 31 12 12 12 12 12 13 13 12 20 9 9 24 10 10 10 10 10 10 10 10 10 10 10 10 10 10 10 10 10 10 10 10 10 
10 10 10 10 10 10 10 10 10 10 10 10 10 10 10 10 10 10 10 10 16 12 12 12 12 17 26 10 10 16 12 12 12 12 12 12 12 12 12 12 31 31 31 12 12 12 20 9 9 24 10 10 10 19 25 12 12 12 12 13 13 12 12 12 12 31 31 31 12 12 12 12 12 12 20 24 10 10 10 10 10 10 10 10 10 10 10 10 10 10 10 10 10 10 10 10 10 10 10 10 
10 10 10 10 10 10 10 10 10 10 10 10 10 10 10 10 10 10 10 10 16 12 12 12 12 12 17 26 10 16 12 12 12 12 12 12 12 12 12 31 31 31 31 12 12 12 23 10 10 10 10 10 10 16 12 12 12 12 13 13 12 12 12 12 31 12 12 31 31 12 12 12 12 12 23 10 10 10 10 10 10 10 10 10 10 10 10 10 10 10 10 10 10 10 10 10 10 10 10 10 
10 10 10 10 10 10 10 10 10 10 10 10 10 10 10 10 10 10 10 10 16 12 31 31 28 12 12 17 32 25 12 12 12 12 12 31 12 12 12 31 12 12 12 12 20 9 24 10 10 10 10 19 32 25 12 12 12 12 13 12 12 12 12 31 29 28 12 12 12 12 12 12 20 9 24 10 10 10 10 10 10 10 10 10 10 10 10 10 10 10 10 10 10 10 10 10 10 10 10 10 
10 10 10 10 10 10 10 10 10 10 10 10 10 10 10 10 10 10 10 10 16 12 12 31 29 12 12 12 14 12 12 12 12 12 31 31 12 12 12 12 12 12 12 20 24 10 10 10 10 10 10 16 12 13 12 12 12 12 13 13 12 12 12 12 12 12 12 13 13 12 12 20 24 10 10 10 10 10 10 10 10 10 10 10 10 10 10 10 10 10 10 10 10 10 10 10 10 10 10 10 
10 10 10 10 10 10 10 10 10 10 10 10 10 10 10 10 10 10 10 10 16 12 12 31 31 12 12 14 14 14 14 14 12 31 29 12 12 14 14 14 14 12 20 24 10 10 10 10 19 32 32 25 12 13 12 29 31 31 12 13 12 12 31 31 12 12 13 13 12 12 20 24 10 10 10 10 10 10 10 10 10 10 10 10 10 10 10 10 10 10 10 10 10 10 10 10 10 10 10 10 
10 10 10 10 10 10 10 10 10 10 10 10 10 10 10 10 10 10 10 10 16 12 12 12 31 12 12 14 12 12 12 14 14 14 14 14 14 14 12 12 12 20 24 10 10 10 10 10 16 12 12 12 13 13 31 31 31 12 12 13 13 13 12 12 13 13 13 12 12 12 23 10 10 10 10 10 10 10 10 10 10 10 10 10 10 10 10 10 10 10 10 10 10 10 10 10 10 10 10 10 
10 10 10 10 10 10 10 10 10 10 10 10 10 10 10 10 10 10 10 10 16 12 12 12 12 12 12 14 14 12 12 12 12 28 12 12 12 12 12 12 20 24 10 10 10 10 10 19 25 12 12 12 13 12 12 12 12 12 12 13 13 13 13 13 13 12 12 12 29 20 24 10 10 10 10 10 10 10 10 10 10 10 10 10 10 10 10 10 10 10 10 10 10 10 10 10 10 10 10 10 
10 10 10 10 10 10 10 10 10 10 10 10 10 10 10 10 10 10 10 10 16 12 12 12 12 12 12 29 12 12 12 12 12 12 12 12 12 12 29 12 23 10 10 10 10 10 10 16 12 12 12 12 12 12 12 12 12 12 12 12 12 12 12 12 12 12 12 12 12 23 10 10 10 10 10 10 10 10 10 10 10 10 10 10 10 10 10 10 10 10 10 10 10 10 10 10 10 10 10 10 
10 10 10 10 10 10 10 10 10 10 10 10 10 10 10 10 10 10 10 10 15 9 9 9 9 9 9 9 9 9 9 9 9 9 9 9 9 9 9 9 24 10 10 10 10 10 10 15 9 9 9 9 9 9 9 9 9 9 9 9 9 9 9 9 9 9 9 9 9 24 10 10 10 10 10 10 10 10 10 10 10 10 10 10 10 10 10 10 10 10 10 10 10 10 10 10 10 10 10 10 
10 10 10 10 10 10 10 10 10 10 10 10 10 10 10 10 10 10 10 10 10 10 10 10 10 10 10 10 10 10 10 10 10 10 10 10 10 10 10 10 10 10 10 10 10 10 10 10 10 10 10 10 10 10 10 10 10 10 10 10 10 10 10 10 10 10 10 10 10 10 10 10 10 10 10 10 10 10 10 10 10 10 10 10 10 10 10 10 10 10 10 10 10 10 10 10 10 10 10 10 
10 10 10 10 10 10 10 10 10 10 10 10 10 10 10 10 10 10 10 10 10 10 10 10 10 10 10 10 10 10 10 10 10 10 10 10 10 10 10 10 10 10 10 10 10 10 10 10 10 10 10 10 10 10 10 10 10 10 10 10 10 10 10 10 10 10 10 10 10 10 10 10 10 10 10 10 10 10 10 10 10 10 10 10 10 10 10 10 10 10 10 10 10 10 10 10 10 10 10 10 
10 10 10 10 10 10 10 10 10 10 10 10 10 10 10 10 10 10 10 10 10 10 10 10 10 10 10 10 10 10 10 10 10 10 10 10 10 10 10 10 10 10 10 10 10 10 10 10 10 10 10 10 10 10 10 10 10 10 10 10 10 10 10 10 10 10 10 10 10 10 10 10 10 10 10 10 10 10 10 10 10 10 10 10 10 10 10 10 10 10 10 10 10 10 10 10 10 10 10 10 
10 10 10 10 10 10 10 10 10 10 10 10 10 10 10 10 10 10 10 10 10 10 10 10 10 10 10 10 10 10 10 10 10 10 10 10 10 10 10 10 10 10 10 10 10 10 10 10 10 10 10 10 10 10 10 10 10 10 10 10 10 10 10 10 10 10 10 10 10 10 10 10 10 10 10 10 10 10 10 10 10 10 10 10 10 10 10 10 10 10 10 10 10 10 10 10 10 10 10 10 
10 10 10 10 10 10 10 10 10 10 10 10 10 10 10 10 10 10 10 10 10 10 10 10 10 10 10 10 10 10 10 10 10 10 10 10 10 10 10 10 10 10 10 10 10 10 10 10 10 10 10 10 10 10 10 10 10 10 10 10 10 10 10 10 10 10 10 10 10 10 10 10 10 10 10 10 10 10 10 10 10 10 10 10 10 10 10 10 10 10 10 10 10 10 10 10 10 10 10 10 
10 10 10 10 10 10 10 10 10 10 10 10 10 10 10 10 10 10 10 10 10 10 10 10 10 10 10 10 10 10 10 10 10 10 10 10 10 10 10 10 10 10 10 10 10 10 10 10 10 10 10 10 10 10 10 10 10 10 10 10 10 10 10 10 10 10 10 10 10 10 10 10 10 10 10 10 10 10 10 10 10 10 10 10 10 10 10 10 10 10 10 10 10 10 10 10 10 10 10 10 
10 10 10 10 10 10 10 10 10 10 10 10 10 10 10 10 10 10 10 10 10 10 10 10 10 10 10 10 10 10 10 10 10 10 10 10 10 10 10 10 10 10 10 10 10 10 10 10 10 10 10 10 10 10 10 10 10 10 10 10 10 10 10 10 10 10 10 10 10 10 10 10 10 10 10 10 10 10 10 10 10 10 10 10 10 10 10 10 10 10 10 10 10 10 10 10 10 10 10 10 
10 10 10 10 10 10 10 10 10 10 10 10 10 10 10 10 10 10 10 10 10 10 10 10 10 10 10 10 10 10 10 10 10 10 10 10 10 10 10 10 10 10 10 10 10 10 10 10 10 10 10 10 10 10 10 10 10 10 10 10 10 10 10 10 10 10 10 10 10 10 10 10 10 10 10 10 10 10 10 10 10 10 10 10 10 10 10 10 10 10 10 10 10 10 10 10 10 10 10 10 
10 10 10 10 10 10 10 10 10 10 10 10 10 10 10 10 10 10 10 10 10 10 10 10 10 10 10 10 10 10 10 10 10 10 10 10 10 10 10 10 10 10 10 10 10 10 10 10 10 10 10 10 10 10 10 10 10 10 10 10 10 10 10 10 10 10 10 10 10 10 10 10 10 10 10 10 10 10 10 10 10 10 10 10 10 10 10 10 10 10 10 10 10 10 10 10 10 10 10 10 
10 10 10 10 10 10 10 10 10 10 10 10 10 10 10 10 10 10 10 10 10 10 10 10 10 10 10 10 10 10 10 10 10 10 10 10 10 10 10 10 10 10 10 10 10 10 10 10 10 10 10 10 10 10 10 10 10 10 10 10 10 10 10 10 10 10 10 10 10 10 10 10 10 10 10 10 10 10 10 10 10 10 10 10 10 10 10 10 10 10 10 10 10 10 10 10 10 10 10 10 
10 10 10 10 10 10 10 10 10 10 10 10 10 10 10 10 10 10 10 10 10 10 10 10 10 10 10 10 10 10 10 10 10 10 10 10 10 10 10 10 10 10 10 10 10 10 10 10 10 10 10 10 10 10 10 10 10 10 10 10 10 10 10 10 10 10 10 10 10 10 10 10 10 10 10 10 10 10 10 10 10 10 10 10 10 10 10 10 10 10 10 10 10 10 10 10 10 10 10 10 
10 10 10 10 10 10 10 10 10 10 10 10 10 10 10 10 10 10 10 10 10 10 10 10 10 10 10 10 10 10 10 10 10 10 10 10 10 10 10 10 10 10 10 10 10 10 10 10 10 10 10 10 10 10 10 10 10 10 10 10 10 10 10 10 10 10 10 10 10 10 10 10 10 10 10 10 10 10 10 10 10 10 10 10 10 10 10 10 10 10 10 10 10 10 10 10 10 10 10 10 
10 10 10 10 10 10 10 10 10 10 10 10 10 10 10 10 10 10 10 10 10 10 10 10 10 10 10 10 10 10 10 10 10 10 10 10 10 10 10 10 10 10 10 10 10 10 10 10 10 10 10 10 10 10 10 10 10 10 10 10 10 10 10 10 10 10 10 10 10 10 10 10 10 10 10 10 10 10 10 10 10 10 10 10 10 10 10 10 10 10 10 10 10 10 10 10 10 10 10 10 
10 10 10 10 10 10 10 10 10 10 10 10 10 10 10 10 10 10 10 10 10 10 10 10 10 10 10 10 10 10 10 10 10 10 10 10 10 10 10 10 10 10 10 10 10 10 10 10 10 10 10 10 10 10 10 10 10 10 10 10 10 10 10 10 10 10 10 10 10 10 10 10 10 10 10 10 10 10 10 10 10 10 10 10 10 10 10 10 10 10 10 10 10 10 10 10 10 10 10 10 
10 10 10 10 10 10 10 10 10 10 10 10 10 10 10 10 10 10 10 10 10 10 10 10 10 10 10 10 10 10 10 10 10 10 10 10 10 10 10 10 10 10 10 10 10 10 10 10 10 10 10 10 10 10 10 10 10 10 10 10 10 10 10 10 10 10 10 10 10 10 10 10 10 10 10 10 10 10 10 10 10 10 10 10 10 10 10 10 10 10 10 10 10 10 10 10 10 10 10 10 
10 10 10 10 10 10 10 10 10 10 10 10 10 10 10 10 10 10 10 10 10 10 10 10 10 10 10 10 10 10 10 10 10 10 10 10 10 10 10 10 10 10 10 10 10 10 10 10 10 10 10 10 10 10 10 10 10 10 10 10 10 10 10 10 10 10 10 10 10 10 10 10 10 10 10 10 10 10 10 10 10 10 10 10 10 10 10 10 10 10 10 10 10 10 10 10 10 10 10 10 
10 10 10 10 10 10 10 10 10 10 10 10 10 10 10 10 10 10 10 10 10 10 10 10 10 10 10 10 10 10 10 10 10 10 10 10 10 10 10 10 10 10 10 10 10 10 10 10 10 10 10 10 10 10 10 10 10 10 10 10 10 10 10 10 10 10 10 10 10 10 10 10 10 10 10 10 10 10 10 10 10 10 10 10 10 10 10 10 10 10 10 10 10 10 10 10 10 10 10 10 
10 10 10 10 10 10 10 10 10 10 10 10 10 10 10 10 10 10 10 10 10 10 10 10 10 10 10 10 10 10 10 10 10 10 10 10 10 10 10 10 10 10 10 10 10 10 10 10 10 10 10 10 10 10 10 10 10 10 10 10 10 10 10 10 10 10 10 10 10 10 10 10 10 10 10 10 10 10 10 10 10 10 10 10 10 10 10 10 10 10 10 10 10 10 10 10 10 10 10 10 
10 10 10 10 10 10 10 10 10 10 10 10 10 10 10 10 10 10 10 10 10 10 10 10 10 10 10 10 10 10 10 10 10 10 10 10 10 10 10 10 10 10 10 10 10 10 10 10 10 10 10 10 10 10 10 10 10 10 10 10 10 10 10 10 10 10 10 10 10 10 10 10 10 10 10 10 10 10 10 10 10 10 10 10 10 10 10 10 10 10 10 10 10 10 10 10 10 10 10 10 
10 10 10 10 10 10 10 10 10 10 10 10 10 10 10 10 10 10 10 10 10 10 10 10 10 10 10 10 10 10 10 10 10 10 10 10 10 10 10 10 10 10 10 10 10 10 10 10 10 10 10 10 10 10 10 10 10 10 10 10 10 10 10 10 10 10 10 10 10 10 10 10 10 10 10 10 10 10 10 10 10 10 10 10 10 10 10 10 10 10 10 10 10 10 10 10 10 10 10 10 
10 10 10 10 10 10 10 10 10 10 10 10 10 10 10 10 10 10 10 10 10 10 10 10 10 10 10 10 10 10 10 10 10 10 10 10 10 10 10 10 10 10 10 10 10 10 10 10 10 10 10 10 10 10 10 10 10 10 10 10 10 10 10 10 10 10 10 10 10 10 10 10 10 10 10 10 10 10 10 10 10 10 10 10 10 10 10 10 10 10 10 10 10 10 10 10 10 10 10 10 
